111111111111111111111111111111111111111111111111111111111111111111111111111111111111111111111111
100000000000000000000000000000000000000000000000000000000000000000000000000000000000000000000001
100000000000000000000000000000000000000000000000000000000000000000000000000000000000000000000001
100000000000000000000000000000000000000000000000000000000000000000000000000000000000000000000001
100000000000000000000000000000000000000000000000000000000000000000000000000000000000000000000001
100000000000000000000000000000000000000000000000000000000000000000000000000000000000000000000001
100000000000000000000000000000000000000000000000000000000000000000000000000000000000000000000001
100000000000000000000000000000000000000000000000000000000000000000000000000000000000000000000001
100000000000000000000000000000000000000000000000000000000000000000000000000000000000000000000001
100000000000000000000000000000000000000000000000000000000000000000000000000000000000000000000001
100000000000000000000000000000000000000000000000000000000000000000000000000000000000000000000001
100000000000000000001000000010000000000000000000000000000000000000000000000000000000000000000001
100000000000000000001000000010000000000000000000000000000100000000000000000000000000000000000001
100000000000000000001000000010000000000000000020000000000100000000000000011000000000000000000001
1000s0000000000000001222222210000002200000000010000000000100000000000000111100001110000000e00001
111111111111111111111111111111111111111111111111111111111111111111111111111111111111111111111111